wwwwwwwwwwwwwwwwwwwwwwwwww
w------------------------w
w-----c------------------w
w------------------------w
w------w-------A---------w
w------w-----------------w
w------wwwwwwwwwwww------w
w------w-----------------w
w------w-------------c---w
w------------------------w
w------------------------w
w------------e-----------w
wwwwwwwwwwwwwwwwwwwwwwwwww