wwwwwwwwwwwwwwwwwwwwwwwwww
w----x--w--A-------------w
w-------w----------w-x---w
wx-----------------www---w
w------------------------w
w-------x----------------w
w----wwwwwwwwww----------w
w-------------w----------w
w-x-----------w------c---w
w----------x--w---x----x-w
w-------------w----------w
wx---------e--w------x---w
wwwwwwwwwwwwwwwwwwwwwwwwww