wwwwwwwwwwwwwwwwwwwwwwwwww
w-----c------------------w
w------------------------w
w-----w-------A----------w
w-----w------------------w
w-----w-------wwwww------w
w-----w------------------w
w-----w------------------w
w-----wwwwwwwwww---------w
w------------------------w
w------------------------w
w------------e-----------w
wwwwwwwwwwwwwwwwwwwwwwwwww