wwwwwwwwwwwwwwwwwwwwwwwwww
w-----c----A-------------w
w------------------------w
w------------------------w
w------------------------w
w------------------------w
w------------------------w
w------------------------w
w------------------------w
w------------------------w
w------------------------w
w-------------------e----w
wwwwwwwwwwwwwwwwwwwwwwwwww
