wwwwwwwwwwwwwwwwwwwwwwwwww
w---------A------------wew
w----------------------w-w
w----------------------w-w
w----------------------w-w
w----------------------w-w
www-wwwwwwwwwwwwwwwwwwww-w
w----------------------w-w
w----------------------w-w
w----------------------w-w
w----------------------w-w
w----------------------w-w
w----------------------w-w
w----------------------w-w
w----------------------w-w
wwwwwwwwwwwwwwwwwwwww-ww-w
w----------------------w-w
w----------------------w-w
w----------------------w-w
w----------------------w-w
w----------------------w-w
w----------------------w-w
w----------------------w-w
w----------------------w-w
www-wwwwwwwwwwwwwwwwwwww-w
w----------------------w-w
w----------------------w-w
w----------------------w-w
w----------------------w-w
w----------------------w-w
w----------------------w-w
w----------------------w-w
w----------------------w-w
wwwwwwwwwwwwwwwwwwwww-ww-w
w----------------------w-w
w----------------------w-w
w----------------------w-w
w----------------------w-w
w----------------------w-w
w----------------------w-w
w----------------------w-w
w----------------------w-w
www-wwwwwwwwwwwwwwwwwwww-w
w----------------------w-w
w----------------------w-w
w----------------------w-w
w----------------------w-w
w------------------------w
wwwwwwwwwwwwwwwwwwwwwwwwww
