wwwwwwwwwwwwwwwwwwwwwwwwwwwwwwwwwwwwwwwwwwwwwwwwwwwwwwwwwwwwww
w---------A--------------------------------------------------w
w------------------------------------------------------------w
w------------------------------------------------------------w
www-wwwwwwwwwwwwwwwwwwwwwwwwwwwwwwwwwwwwwwwwwwwwwwwwwwwwwwww-w
w------------------------------------------------------------w
wwwwwwwwwwwwwwwwwwwwwwwwwwwwwwwwwwwwwwwwwwwwwwwwwwwwwwwwwwww-w
w------------------------------------------------------------w
w------------------------------------------------------------w
w------------------------------------------------------------w
w------------------------------------------------------------w
w-wwwwwwwwwwwwwwwwwwwwwwwwwwwwwwwwwwwwwwwwwwwwwwwwwwwwwwwwwwww
w------------------------------------------------------------w
wwwwwwwwwwwwwwwwwwwwwwwwwwwwwwwwwwwwwwwwwwwwwwwwwwwwwwwwwwww-w
w------------------------------------------------------------w
www-wwwwwwwwwwwwwwwwwwwwwwwwwwwwwwwwwwwwwwwwwwwwwwwwwwwwwwwwww
w------------------------------------------------------------w
wwwwwwwwwwwwwwwwwwwwwwwwwwwwwwwwwwwwwwwwwwwwwwwwwwwwwwwwwwww-w
w---------e--------------------------------------------------w
wwwwwwwwwwwwwwwwwwwwwwwwwwwwwwwwwwwwwwwwwwwwwwwwwwwwwwwwwwwwww

wwwwwwwwwwwwwwwwwwwwwwwwww
w---------A------------wew
w----------------------w-w
w----------------------w-w
w----------------------w-w
w----------------------w-w
www-wwwwwwwwwwwwwwwwwwww-w
w----------------------w-w
w----------------------w-w
w----------------------w-w
w----------------------w-w
w----------------------w-w
w----------------------w-w
w----------------------w-w
w----------------------w-w
wwwwwwwwwwwwwwwwwwwww-ww-w
w----------------------w-w
w----------------------w-w
w----------------------w-w
w----------------------w-w
w----------------------w-w
w----------------------w-w
w----------------------w-w
w----------------------w-w
www-wwwwwwwwwwwwwwwwwwww-w
w----------------------w-w
w----------------------w-w
w----------------------w-w
w----------------------w-w
w----------------------w-w
w----------------------w-w
w----------------------w-w
w----------------------w-w
wwwwwwwwwwwwwwwwwwwww-ww-w
w----------------------w-w
w----------------------w-w
w----------------------w-w
w----------------------w-w
w----------------------w-w
w----------------------w-w
w----------------------w-w
w----------------------w-w
www-wwwwwwwwwwwwwwwwwwww-w
w----------------------w-w
w----------------------w-w
w----------------------w-w
w----------------------w-w
w------------------------w
wwwwwwwwwwwwwwwwwwwwwwwwww

wwwwwwwwwwwwwwwwwwwwwwwwwwwwwwwwwwwwwwwwwwwww
w----------------------------------------Awew
w-----------------------------------------w-w
w-----------------------------------------w-w
w-----------------------------------------w-w
w-----------------------------------------w-w
wwwwwwwwwwwwwwwwwwwwww-wwwwwwwwwwwwwwwwwwww-w
w-----------------------------------------w-w
w-----------------------------------------w-w
w-----------------------------------------w-w
w-----------------------------------------w-w
w-----------------------------------------w-w
w-----------------------------------------w-w
w-----------------------------------------w-w
w-----------------------------------------w-w
wwwwwwwwwwwwwwwwwwwww-wwwwwwwwwwwwwwwwwwwww-w
w-----------------------------------------w-w
w-----------------------------------------w-w
w-----------------------------------------w-w
w-----------------------------------------w-w
w-----------------------------------------w-w
www-wwwwwwwwwwwwwwwwwwwwwwwwwwwwwwwwwwwwwww-w
w---w------------------w------------------w-w
w---w------------------w------------------w-w
w---w------------------w------------------w-w
w---w-------------------------------------w-w
w----------------------w--------------------w
wwwwwwwwwwwwwwwwwwwwwwwwwwwwwwwwwwwwwwwwwwwww
